8888888888888888888888888888
8888888888888888888888888888
8888888888888888888888888888
0000000000000000000000000000
0111111111111001111111111110
0100001000001001000001000010
0700001000001001000001000070
0100001000001001000001000010
0111111111111111111111111110
0100001001000000001001000010
0100001001000000001001000010
0111111001111001111001111110
0000001000008008000001000000
8888801000008008000001088888
8888801008888838888001088888
8888801008000000008001088888
0000001008088888808001000000
0888881888084856808881888880
0000001008088888808001000000
8888801008000000008001088888
8888801008888888888001088888
8888801008000000008001088888
0000001008000000008001000000
0111111111111001111111111110
0100001000001001000001000010
0100001000001001000001000010
0711001111111821111111001170
0001001001000000001001001000
0001001001000000001001001000
0111111001111001111001111110
0100000000001001000000000010
0100000000001001000000000010
0111111111111111111111111110
0000000000000000000000000000
8888888888888888888888888888
8888888888888888888888888888
